111111
1CPE01
100001
111111
111111