1111111111111
10000C0000001
1E000000C0001
10000000C0001
1000000P00001
1111111111111