11111111
1000P001
10000001
1C000001
10000E01
11111111