111111111111111111111111111111
110000000000000000000000000001
111000000000000000000000000001
111000000000010000000000000001
11P100000000101000000000000001
1000000000000000E0000000000001
100000000000010000000000000001
100000000000000000000000000001
100000000000000000000000000001
100000000000000000000000000001
100000000000000000000000000001
100000000000000000000000000001
1000000000000000000000CC001111
100000000000000000000000100C11
100000000000000000000000101111
110000000000000000000000001001
111111111111111111111111111111