111111111111111111111111111111
100000000000000000000000000001
11E100000000000000000000000001
111000000000010000000000000001
11P100000000101000000000000001
100000000000000000000000000001
100000000000010000000000000001
100000000000000000000000000001
100000000000000000000000000001
100000000000000000000000000001
100000000000000000000000000001
100000000000000000000000000001
100000000000000000000000000001
100000000000000000000000000001
1C0000000000000000000000000001
111111111111111111111111111111