111111
10PE01
100001
100011
1000C1
111111