1111111111111111111111
100000C00000C0CC0C0001
100P0C0C0CC0CC00C0E001
1001110011101110111001
1001010000100010101001
1000010011101110001001
1000010000100010001001
1000111011101110001001
1000000000000000000001
1111111111111111111111